filename, language, C++, Markdown, Properties, JSON with Comments, comment, blank, total
c:\Users\phil\Documents\Arduino\libraries\PangolinMQTT\README.md, Markdown, 0, 76, 0, 0, 0, 51, 127
c:\Users\phil\Documents\Arduino\libraries\PangolinMQTT\docs\101.md, Markdown, 0, 80, 0, 0, 0, 28, 108
c:\Users\phil\Documents\Arduino\libraries\PangolinMQTT\docs\api.md, Markdown, 0, 91, 0, 0, 0, 32, 123
c:\Users\phil\Documents\Arduino\libraries\PangolinMQTT\docs\pl.md, Markdown, 0, 156, 0, 0, 0, 93, 249
c:\Users\phil\Documents\Arduino\libraries\PangolinMQTT\docs\qos.md, Markdown, 0, 73, 0, 0, 0, 68, 141
c:\Users\phil\Documents\Arduino\libraries\PangolinMQTT\docs\rn008.md, Markdown, 0, 25, 0, 0, 0, 19, 44
c:\Users\phil\Documents\Arduino\libraries\PangolinMQTT\docs\rn100.md, Markdown, 0, 38, 0, 0, 0, 28, 66
c:\Users\phil\Documents\Arduino\libraries\PangolinMQTT\docs\rn101.md, Markdown, 0, 28, 0, 0, 0, 21, 49
c:\Users\phil\Documents\Arduino\libraries\PangolinMQTT\docs\stm32.md, Markdown, 0, 17, 0, 0, 0, 13, 30
c:\Users\phil\Documents\Arduino\libraries\PangolinMQTT\docs\tls.md, Markdown, 0, 34, 0, 0, 0, 20, 54
c:\Users\phil\Documents\Arduino\libraries\PangolinMQTT\examples\ExpertFunctions\ExpertFunctions.ino, C++, 92, 0, 0, 0, 17, 6, 115
c:\Users\phil\Documents\Arduino\libraries\PangolinMQTT\examples\ExpertFunctions\framework.h, C++, 132, 0, 0, 0, 24, 14, 170
c:\Users\phil\Documents\Arduino\libraries\PangolinMQTT\examples\QuickStart\QuickStart.ino, C++, 33, 0, 0, 0, 12, 7, 52
c:\Users\phil\Documents\Arduino\libraries\PangolinMQTT\examples\QuickStart\framework.h, C++, 134, 0, 0, 0, 24, 14, 172
c:\Users\phil\Documents\Arduino\libraries\PangolinMQTT\examples\SessionRecovery1\SessionRecovery1.ino, C++, 74, 0, 0, 0, 29, 9, 112
c:\Users\phil\Documents\Arduino\libraries\PangolinMQTT\examples\SessionRecovery1\framework.h, C++, 128, 0, 0, 0, 24, 14, 166
c:\Users\phil\Documents\Arduino\libraries\PangolinMQTT\examples\SessionRecovery2\SessionRecovery2.ino, C++, 74, 0, 0, 0, 27, 11, 112
c:\Users\phil\Documents\Arduino\libraries\PangolinMQTT\examples\SessionRecovery2\framework.h, C++, 129, 0, 0, 0, 24, 14, 167
c:\Users\phil\Documents\Arduino\libraries\PangolinMQTT\library.properties, Properties, 0, 0, 9, 0, 0, 0, 9
c:\Users\phil\Documents\Arduino\libraries\PangolinMQTT\pango-workspace.code-workspace, JSON with Comments, 0, 0, 0, 8, 0, 0, 8
c:\Users\phil\Documents\Arduino\libraries\PangolinMQTT\src\PANGO.cpp, C++, 179, 0, 0, 0, 33, 19, 231
c:\Users\phil\Documents\Arduino\libraries\PangolinMQTT\src\PANGO.h, C++, 43, 0, 0, 0, 28, 9, 80
c:\Users\phil\Documents\Arduino\libraries\PangolinMQTT\src\Packet.cpp, C++, 141, 0, 0, 0, 30, 13, 184
c:\Users\phil\Documents\Arduino\libraries\PangolinMQTT\src\Packet.h, C++, 99, 0, 0, 0, 24, 8, 131
c:\Users\phil\Documents\Arduino\libraries\PangolinMQTT\src\PangolinMQTT.cpp, C++, 268, 0, 0, 0, 37, 22, 327
c:\Users\phil\Documents\Arduino\libraries\PangolinMQTT\src\PangolinMQTT.h, C++, 179, 0, 0, 0, 74, 16, 269
c:\Users\phil\Documents\Arduino\libraries\PangolinMQTT\src\config.h, C++, 6, 0, 0, 0, 36, 7, 49
c:\Users\phil\Documents\Arduino\libraries\PangolinMQTT\src\mb.cpp, C++, 72, 0, 0, 0, 33, 9, 114
c:\Users\phil\Documents\Arduino\libraries\PangolinMQTT\src\mb.h, C++, 32, 0, 0, 0, 25, 7, 64
Total, -, 1815, 618, 9, 8, 501, 572, 3523